CCCCCCCCCCCCCCCCCCCCCCCCCCCCCCCCCCCCCCCCCCCCCCCCCCCCCCCCCCCCCCCCCCCCCCCCCCCCCCCCCCCCCCCCCCCCCCCCCCCCCCCCCCCCCCCCCCCCCCCCCCCCCCCCCCCCCCCCCCCCCCCCCCCCCCCCCCCCCCCCCCCCC
CWWWWWWWWWWWWWWWWWWWWWWWWWWWWWWWWWWWWWWWWWWWWWWWWWWWWWWWWWWWWWWWWWWWWWWWWWWWWWWWWWWWWWWWWWWWWWWWWWWWWWWWWWWWWWWWWWWWWWWWWWWWWWWWWWWWWWWWWWWWWWWWWWWWWWWWWWWWWWWWWWWWC
C...................................................................................................................................................................C
C...................................................................................................................................................................C
C...................................................................................................................................................................C
C...................................................................................................................................................................C
C...................................................................................................................................................................C
C...................................................................................................................................................................C
C...................................................................................................................................................................C
C...................................................................................................................................................................C
C.......................................................................................CCCCCC......................................................................C
C...........................................................................CCCCCCCCCCCCCWWWWCCCCCCCCCCCC...........................................................C
C...........................................................................CWWWWWWWWWWWW....WWWWWWWWWWWC...........................................................C
C...........................................................................C..%.....................%..C...........................................................C
C...........................................................................C.%.......................%.C...........................................................C
C...........................................................................C..%.........@...........%..C...........................................................C
C...........................................................................C.%.......................%.C...........................................................C
C...........................................................................C..%.....................%..C...........................................................C
C...........................................................................WCCCCC.................CCCCCW...........................................................C
C............................................................................WWWWWCCCCC.......CCCCCWWWWW............................................................C
C.................................................................................WWWWW.......WWWWW.................................................................C
C...................................................................................................................................................................C
C...................................................................................................................................................................C
C...................................................................................................................................................................C
C...................................................................................................................................................................C
C...................................................................................................................................................................C
C...................................................................................................................................................................C
C...................................................................................................................................................................C
C...................................................................................................................................................................C
C...................................................................................................................................................................C
C...................................................................................................................................................................C
C...................................................................................................................................................................C
C...................................................................................................................................................................C
C...................................................................................................................................................................C
C...................................................................................................................................................................C
C...................................................................................................................................................................C
C...................................................................................................................................................................C
C...................................................................................................................................................................C
C...................................................................................................................................................................C
C...................................................................................................................................................................C
C...................................................................................................................................................................C
C...................................................................................................................................................................C
C...................................................................................................................................................................C
C...................................................................................................................................................................C
C...................................................................................................................................................................C
C...................................................................................................................................................................C
C...................................................................................................................................................................C
C..................................................................&.&.&...&.&.&....&.&..&.&.&.........&.&.&.&.&.&..................................................C
C...................................................................&....&.&.&...&.&....&.&.&.&.&.&.....&.&.&.&.&...................................................C
C....................................................................&.&...&.&.&.&.&.&.&.&...&.&.&.&.....&.&.&.&....................................................C
C...................................................................................................................................................................C
C...................................................................................................................................................................C
C...................................................................................................................................................................C
C...................................................................................................................................................................C
C...................................................................................................................................................................C
C...................................................................................................................................................................C
CCCCCCCCCCCCCCCCCCCCCCCCCCCCCCCCCCCCCCCCCCCCCCCCCCCCCCCCCCCCCCCCCCCCCCCCCCCCCCCCCCCCCCCCCCCCCCCCCCCCCCCCCCCCCCCCCCCCCCCCCCCCCCCCCCCCCCCCCCCCCCCCCCCCCCCCCCCCCCCCCCCCC




